NO ./textures/ice 1.xpm
SO ./textures/mossy.xpm
WE./textures/wood.xpm
EA ./textures/wood.png
S  ./textures/pillar.png        
F 184,113,39
R 500 500111111111111111111111111111111111111111

C 51,198, 27

        1111111111111111111111111
        1000000000110000000000001
        1011000001110000002000001
        1001000000000000000000001
111111111011000001110000000000001
100000000011000001110111111111111
111101111111110111000100110011
11110111111111011101010000001
11000000110101011100000010201
10002000000000001100000010201
10000000000000001101010010001
11000001110101011111011110N0111
11110111 1110101 101111010001
11111111 1111111 111111111111